######################################################################
#                                                                    #
#                                                                    #
#                                                                    #
#                                                                    #
#                                                                    #
#                                                                    #
#                                                                    #
#                                                                    #
#                                                                    #
#                                                                    #
#                                                                    #
#                                                                    #
#                                                                    #
#                                                                    #
#                                                                    #
#                                                                    #
#                                                                    #
#                                                                    #
#                                                                    #
#                                                                    #
#                                                                    #
#                                                                    #
#                               S                                    #
#                                                                    #
#                                                                    #
#                                                                    #
#                                                                    #
#                                                                    #
#                                                                    #
#                                                                    #
#                                                                    #
#                                                                    #
#                                                                    #
#                                                                    #
#                                                                    #
#                                                                    #
#                                                                    #
#                                                                    #
#                                                                    #
#                                                                    #
#                                                                    #
#                                                                    #
#                                                                    #
#                                                                    #
#                                                                    #
#                                                                    #
#                                                                    #
#                                                                    #
######################################################################
